name,college,gender,lesson1,lesson2,total
abhijith,stmartins,male,20,45,65
nikhil,cvr,male,0,34,34
vineetha,bvrit,female,1,14,15
sachin,iit,male,3,39,42
luffy,iip,male,100,10,110
zoro,iip,male,99,29,128
naruto,leafvillage,male,45,58,103
sasuke,leafvillage,male,53,83,136
light,deathschool,male,0,99,99
archana,gitam,female,0,45,45
galiprem,gitam,male,99,99,198
valli,gvp,female,0,76,76